WWWWWWWWWWWWWW
W---------P--W
W-----WWWWWWWW
W------------W
WWWWWWW------W
W-G------*-*-W
WWWWWWWWWWWWWW