WWWWWWWWWWWWWWWWWWW
W-------------P---W
W--*---*---*---*--W
W-----------------W
W--*---*---*---*--W
W-G------*-*------W
WWWWWWWWWWWWWWWWWWW