WWWWWWWWWWWWW
WP----------W
W----WWWWWWWW
W-----------W
W--WWWW-*---W
W----G------W
WWWWWWWWWWWWW